Wo, Wo, Ww^Wkf, Ds, Ds, Gs, Gs^Ft, Gs^Ft, Hh^Ft, Gs^Ft, Rd, Gd^Efm, Gd^Efm, Gd^Efm, Re, Re, Gd, Gd, Ds, Ds, Dd, Gs^Qhh, Re^Qhh, Hh^Qhh, Gd^Qhh, Hh, Hh, Gg, Gs^Fms, Gs^Fp, Gs^Ftp, Ss, Ww^Wkf, Ss, Ss, Ss, Sm, Ss, Ss, Ss
Wo, Wo, Ds, Ds^Ewsh, Gs^Efm, Gs, Gs^Ft, Hh^Ft, Hh^Ft, Hh^Ft, Re, Re, Re, Re, Gs^Efm, Gd, Gd, Gd^Efm, Gd, Dd^Ewsh, Ds^Edpp, Gd, Gd^Qhh, Re^Qhh, Gd^Qhh, Hhd, Re, Gs^Fp, Ss^Fms, Gs^Ft, Gs^Fms, Gs^Ftp, Ss, Ss^Em, Rb^Em, Ww, Chw, Ss^Em, Ss^Em, Ss
Ww, Ww^Wkf, Ds, Gs, Gs, Gs^Ft, Rd, Rd, Rr, Rr, Gs, Gs, Gs, Gs, Gd, Hhd, Ds, Gs, Gd^Fts, Gd, Ds, Gd, Gd^Efm, Re, Re, Hhd, Hhd, Hh, Gs, Gs^Fms, Gs^Ftp, Ss, Ww^Ewl, Ss, Ww^Wkf, Ss^Dr, 2 Khw, Ss^Dr, Ss, Ss
Ds, Ds, Gs^Efm, Chr, 1 Khr, Chr, Rr, Rr, Re^Vht, Rr, Re, Hh^Fts, Gll^Fts, Gll^Fts, Gd, Dd, Ds, Gg^Efm, Gd, Gs^Es, Gs, Gd^Qhh, Gd^Qhh, Gd, Hhd, Re, Re^Dr, Md, Hh^Ft, Ss^Ft, Ss^Ftp, Ss, Ww, Ss, Rp, Chw, Chw, Chw^Dr, Sm, Ww^Ewf
Ds, Ds^Ewsh, Gll^Fts, Chr, Ce, Chr, Rr, Gs, Gs^Gvs, Gs, Gll^Fts, Rr, Rr, Gg, Gg^Em, Gd, Ds, Dd^Edpp, Hhd, Gs, Gd, Gg^Qhh, Gs^Fms, Gd, Hh^Es, Hh, Md, Hh^Vhh, Hh^Fds, Md, Md, Ss, Gs^Ftp, Rp^Vhs, Ss, Rp, Ss, Ss^Em, Sm^Em, Ww^Wkf
Hh, Gll^Fts, Gll^Fts, Gs, Rr, Gs^Efm, Rr, Re^Vht, Gs, Gs^Gvs, Hh^Fts, Gll^Fts, Gd, Re, Re, Hhd, Gs^Es, Ds, Gd, Dd, Ds, Gs^Fms, Gs^Fms, Hhd, Hh^Fds, Md^Fds, Md^Fds, Md, Hh, Mm, Mm, Ww^Wkf, Ss, Gs^Ftp, Ww^Wkf, Ww^Bw|r, Ww, Sm, Sm^Em, Ss
Hh, Hh^Ft, Gs^Gvs, Gs^Efm, Rr, Gs^Ebn, Rr, Gs, Gs, Hh^Fts, Gd^Fts, Gs, Gd, Ds^Edpp, Rr, Hh, Gg, Gd, Gd, Ds, Gd, Gd, Gg^Efm, Hh, Ww^Ewl, Wo^Wkf, Wwrt, Ww^Wkf, Gg, Hh^Fds, Gg^Fds, Mm, Hh^Es, Gs^Ftp, Ww^Bw/, Rp, Ss, Ss^Em, Ww^Ewf, Sm
Gs^Eff, Gll^Fts, Rr^Vht, Gs^Gvs, Rr, Rr, Gs, Gs, Gll^Fts, Gs, Gs, Gs^Efm, Ds, Dd, Re, Gg, Re, Gd^Fts, Gg, Gg, Ss, Gs^Fms, Ss, Ww, Gs^Fms, Ss, Gg, Ww^Bw/r, Hh^Fds, Hh^Fds, Mm, Hh, Gg, Rp, Ww, Ww, Ss, Sm, Sm^Em, Ss
Gs^Eff, Gs^Eff, Gs, Rr, Gs, Rr, Gs^Wm, Hh^Fts, Gll^Fts, Ds, Gs^Efm, Gd, Ds, Hhd, Ds, Re, Ds, Re, Rr, Re, Re, Hh, Re, Ww^Ewf, Wo^Bw/r, Gg, Wo, Ww^Wkf, Hh^Fds, Mm^Fds, Mm^Fds, Mm, Hh^Es, Ww^Ewl, Gg, Ss^Em, Sm, Ww^Wkf, Ss, Ss
Gs, Gs, Rr, Re, Gs, Rr, Gs, Gs, Gs, Gs^Es, Gd, Gd, Hhd, Hhd, Re, Re, Gd, Gd, Gd^Fts, Hhd, Gs^Em, Re, Rr, Ww^Bw/r, Wwrt, Ww^Wkf, Hh, Ww^Ewf, Ss, Hh^Vhh, Ss, Hh^Fds, Ww^Ewf, Ss, Gll, Ss, Ss, Ss^Em, Ss, Ss
Rr, Re, Gll^Ft, Gll^Ft, Re^Efm, Re, Gs, Gll^Fts, Gs, Gs, Gd, Ds, Gd, Gd, Re^Vht, Ds, Gd, Ds, Ds, Dd, Gd^Gvs, Gs^Efm, Rr^Vh, Rr, Rr, Ww, Hh^Ebn, Hh, Ss^Es, Ww^Ewl, Gs^Fp, Ww, Ss, Gg, Gg, Gs^Fms, Gs^Fms, Ss, Gll, Ss
Re, Re, Gll^Ft, Re^Vht, Gs, Gs, Gs, Gs^Efm, Gs, Gs, Gg, Ds, Gd, Ds, Re, Gd, Hhd, Dd, Dd, Ds^Edpp, Dd, Dd, Gd, Gg, Hh, Ww^Bw\r, Rr, Gs^Fp, Gs^Fp, Re, Gg^Em, Ss, Re, Re, Rr, Gs^Fp, Re, Gll^Fp, Gg^Efm, Hh
Gs^Ft, Gll^Ft, Gll^Ft, Gs, Ss, Hh^Ft, Gs, Gs^Efm, Gs, Ss, Gg, Gd^Fts, Gs, Gd, Re, Gd, Gd, Ds, Dd, Ds, Ds, Gd, Gs, Gg, Ww^Ewf, Ww, Rr^Vh, Rr, Re, Re, Rr, Rr, Re^Vh, Gg^Gvs, Gg^Gvs, Re, Gg^Efm, Re, Re, Re
Dd, Ds, Gs^Ft, Ss^Em, Gll^Ft, Gll^Ft, Gg, Gg, Gg, Gg, Ss, Gg, Gg, Gll^Fts, Gll^Ft, Re, Re, Ds^Edpp, Ds, Dd, Ds, Gd, Gd^Fts, Gg^Efm, Gg, Wo, Ss^Em, Gg^Es, Hh, Gs, Gg^Es, Re, Re^Eff, Re^Eff, Re^Eff, Gs^Fp, Gs^Fp, Hh, Gg^Em, Gg
Ss, Ds, Ss, Ss, Gll^Ft, Ss, Ww^Bw|r, Ds, Ds, Ss, Rb, Ds, Dd, Gll^Ft, Ds^Edpp, Gll^Fts, Re, Gd, Gd, Hhd, Hh, Gs, Gs, Gs, Gg^Efm, Ww^Wkf, Ss, Gg^Gvs, Gs^Fms, Gs^Fp, Rr, Re, Gs^Fms, Re^Eff, Gg, Gs^Fp, Gg, Gs^Es, Gs^Fp, Hh
Wo, Ss, Ss, Ds^Ewsh, Dd, Ds, Ww^Bw|r, Ww^Ewl, Ss^Wkf, Ss, Ss, Ds, Ss, Ds, Dd^Edpp, Gll^Ft, Gs^Fts, Re^Es, Gs^Es, Gs^Efm, Hh, Ds, Gg, Ss, Gg, Ss^Em, Ww^Ewf, Ss, Hh^Fp, Gs^Fms, Rr, Hh^Fms, Gg^Efm, Gg^Qhh, Hh^Qhh, Gg^Qhh, Gs^Qhh, Hh, Gll^Fms, Hh
Ww, Ww^Ewl, Wo, Wo^Wkf, Ww, Ww, Gll, Ww^Wkf, Ss, Ss, Ss, Ss, Ds^Edpp, Ds, Gg^Efm, Gs^Ft, Re, Re, Gs, Gll^Fts, Gs^Ft, Gg, Gg, Ss^Efm, Ss, Gs, Ss, Gg, Gg^Efm, Gg, Re, Rr, Rr, Gs^Qhh, Co, Gs^Fms, Hh^Qhh, Gs^Fms, Gs^Fms, Hh
Ss, Ww^Wkf, Ss, Wwrt, Ww, Ss, Re, Wo^Wkf, Ww, Dd, Ds^Ewsh, Ss, Ds, Ds, Gg, Re^Vh, Ds^Edpp, Ds, Gs^Edpp, Hh^Fts, Gll^Fts, Gg, Gs^Fp, Gll^Fp, Gs^Fp, Ss, Gg, Gg, Re^Eff, Re^Eff, Gg^Eff, Gg^Vh, Gs^Qhh, Ce, 3 Ko, Co, Gs^Fds, Gs^Qhh, Gll^Qhh, Gs^Qhh
Ss, Ss, Gs^Fts, Dd, Ss, Ww, Ww^Bw|r, Ww, Ww, Wo, Ww^Ewf, Dd, Gs^Ft, Ss, Ss, Ss, Gll^Ft, Ds, Gg^Es, Gg, Gg^Efm, Gg, Hh^Fp, Gs^Fms, Gs, Ss, Ss^Em, Ss, Gg, Re^Eff, Gs^Fds, Hh^Efm, Hh^Fp, Gs^Qhh, Ce, Co, Gs^Qhh, Gll^Fms, Gs^Es, Gs
Ss, Gs^Ft, Ds^Es, Ds^Es, Ss^Em, Ww^Ewf, Ss^Vhs, Ss, Ww^Ewl, Wo, Wo^Wkf, Ds^Es, Gs^Ft, Ss, Gs^Ft, Gg, Gg, Gs^Fts, Gg^Efm, Gs^Fms, Gg, Gg, Hh^Fms, Gll^Fms, Gs^Fp, Ww^Ewf, Gs^Fp, Ss, Gg, Gll^Fms, Hh, Hh, Gs^Fms, Hh, Rr, Hh, Hh, Gs^Qhh, Hh, Hh^Es
Ds, Dd, Ds, Ss^Efm, Ww^Ewf, Ss^Em, Ss, Ss, Ss, Ww^Wkf, Ww^Wkf, Wwrt, Ww, Ss, Gs^Ft, Gs^Fts, Gg^Em, Gg, Gg^Qhu, Gg^Qhu, Hh^Fp, Gll^Fp, Gs^Fms, Gs^Fms, Gll^Fp, Ss, Hh^Fms, Ss, Ss, Gs^Fms, Hh^Fp, Gs^Fms, Gs^Fms, Gs, Re, Hh^Efm, Hh^Fp, Hh^Fp, Gs^Qhh, Gs^Fp
Gs^Ft, Gs^Fts, Dd, Ss, Ss^Efm, Ss, Ss, Ww^Ewl, Ss^Em, Ds^Ewsh, Dd, Wo, Ww^Ewl, Gs^Ft, Gs^Ft, Gs^Ft, Gs^Fts, Gs^Fms, Gg^Qhu, Gg^Qhu, Gll^Fp, Gs^Fms, Gs^Fms, Gll^Fp, Ss, Rb, Gs^Fp, Ss, Hh, Hh, Gs^Fms, Hh, Gs, Hh^Fp, Hh^Fp, Rr, Gs^Fp, Gs^Fms, Gs^Qhh, Gs^Qhh
Ds, Gs^Ft, Gs^Ft, Ds, Ds, Ww^Ewf, Ww^Ewf, Ss, Ss, Ww^Ewl, Ss, Wo, Ww, Ww, Ss, Ss, Gs^Ft, Gs^Ft, Gs^Qhu, Gs^Qhu, Gs^Fp, Gs^Fp, Ss, Ss, Ss, Ss, Gg, Gs, Hh, Gs^Fp, Gs^Fp, Gs^Fp, Hh^Fp, Hh^Fp, Gs, Re, Gs^Fp, Gs^Fms, Gs^Fp, Gs^Fp
