Wo, Wo, Ww^Wkf, Ds, Ds, Gs, Gs^Ft, Gs^Ft, Gs^Ft, Gs^Ft, Rd, Rd, Re, Re, Re, Re, Gd, Gd, Ds, Ds, Dd, Gs^Qhh, Re^Qhh, Hh^Qhh, Gd^Qhh, Hh, Hh, Gg, Gs^Fms, Gs^Fp, Gs^Ftp, Ss, Ss, Ss, Ss, Ss, Sm, Ss, Ss, Ss
Wo, Wo, Ds, Ds^Ewsh, Gs^Efm, Gs, Gs^Ft, Gs^Ft, Gs^Ft, Gs^Ft, Re, Re, Re, Re, Gs^Efm, Gs, Gd, Gd^Efm, Gd, Dd^Ewsh, Ds^Edpp, Gd, Gd^Qhh, Re^Qhh, Gd^Qhh, Hhd, Hh, Gs^Fp, Gs^Fms, Gs^Fp, Gs^Fms, Gs^Ftp, Ss, Ss^Em, Rb, Ss, Ss, Ss, Ss^Em, Ss
Ww, Ww^Wkf, Ds, Gs, Chr, Gs^Ft, Rd, Rd, Rr, Rr, Gs, Gs, Gs, Gs, Gd, Gd, Ds, Gs, Gd^Fts, Gd, Ds, Gd, Gd^Efm, Re, Re, Hhd, Hhd, Hh, Hh, Gs^Fms, Gs^Ftp, Ss, Ss, Ss, Ss, Ss, Ss, Ss, Ss, Ss
Ds, Ds, Gs^Efm, Chr, 1 Khr, Chr, Rr, Rr, Re^Vht, Rr, Re, Gll^Fts, Gll^Fts, Gll^Fts, Gd, Dd, Ds, Gg^Efm, Gd, Gs^Es, Gs, Gd^Qhh, Gd^Qhh, Gd, Hhd, Hhd, Hhd^Dr, Md, Md, Hh, Gs^Ftp, Ss, Ss, Ss, Rb, Sm, Ss^Em, Ss, Sm, Ss
Ds, Ds^Ewsh, Gll^Fts, Chr, Chr, Chr, Rr, Gs, Gs^Gvs, Gs, Gll^Fts, Rr, Rr, Gg, Gg^Em, Gd, Ds, Dd^Edpp, Gd, Gs, Gd, Gg^Qhh, Gs^Fms, Gd, Hh^Es, Hh, Md, Hh^Vhh, Hh, Md, Md, Ss, Gs^Ftp, Rb^Vhs, Ss, Rb, Ss, Ss^Em, Sm, Ss
Ds, Gll^Fts, Gll^Fts, Chr, Chr, Chr, Rr, Re^Vht, Gs, Gs^Gvs, Gll^Fts, Gll^Fts, Gd, Re, Re, Gd, Gs^Es, Ds, Gd, Dd, Ds, Gs^Fms, Gs^Fms, Hhd, Mm, Md, Md, Md, Hh, Mm, Mm, Ss, Ss, Gs^Ftp, Ss, Ss^Bw|r, Ss, Sm, Sm, Ss
Ds, Gll^Ft, Gs^Gvs, Gs^Efm, Gs, Gs^Ebn, Rr, Gs, Gs, Gll^Fts, Gd^Fts, Gs, Gd, Ds^Edpp, Rr, Gg, Gg, Gd, Gd, Ds, Gd, Gd, Gg^Efm, Hh, Ww^Ewl, Wo, Wwrt, Ww^Wkf, Gg, Mm, Mm, Mm, Hh^Es, Gs^Ftp, Ss^Bw/, Rb, Ss, Ss^Em, Ss, Sm
Gs^Eff, Gll^Fts, Rr^Vht, Gs^Gvs, Rr, Rr, Gs, Gs, Gll^Fts, Gs, Gs, Gs^Efm, Ds, Dd, Re, Gg, Re, Gd^Fts, Gg, Gg, Gg, Gs^Fms, Gg, Ww, Gs^Fms, Wo, Gg, Ww^Bw/r, Mm, Mm, Mm, Mm, Mm, Rb, Gg, Ss, Ss, Sm, Sm, Ss
Gs^Eff, Gs^Eff, Re, Rr, Re, Rr, Gs^Wm, Gll^Fts, Gll^Fts, Ds, Gs^Efm, Gd, Ds, Gd, Ds, Re, Ds, Re, Rr, Re, Re, Gg^Efm, Re, Ww^Ewf, Wo^Bw/r, Gg, Wo, Ww^Wkf, Mm, Mm, Mm, Mm, Hh^Es, Hh, Gg, Ss^Em, Sm, Ss, Ss, Ss
Re, Rr, Rr, Re, Gs, Rr, Gs, Gs, Gs, Gs^Es, Gd, Gd, Gd, Gd, Re, Re, Gd, Gd, Gd^Fts, Gs, Gs^Em, Re, Rr, Ww^Bw/r, Wwrt, Ww^Wkf, Hh, Hh^Efm, Hh^Dr, Hh^Vhh, Gs^Fp, Hh, Gg, Gg^Efm, Gll, Ss, Ss, Ss^Em, Ss, Ss
Rr, Re, Gll^Ft, Gll^Ft, Re^Efm, Re, Gs, Gll^Fts, Gs, Gs, Gd, Ds, Gd, Gd, Re^Vht, Ds, Gd, Ds, Ds, Dd, Gd^Gvs, Gs^Efm, Rr^Vh, Rr, Rr, Ww, Hh^Ebn, Hh, Gg^Es, Re^Efm, Gs^Fp, Gs^Fms, Gg, Gg, Gg, Gs^Fms, Gs^Fms, Ss, Gll, Ss
Re, Re, Gll^Ft, Gs^Vht, Gs, Gs, Gs, Gs^Efm, Gs, Gs, Gg, Ds, Gd, Ds, Re, Gd, Gd^Efm, Dd, Dd, Ds^Edpp, Dd, Dd, Gd, Gg, Hh, Ww^Bw\r, Rr, Gs^Fp, Gs^Fp, Re, Gg^Em, Gg, Re, Re, Rr, Gs^Fp, Re, Gll^Fp, Gg^Efm, Gg
Gs^Ft, Gll^Ft, Gll^Ft, Gs, Ss, Gll^Ft, Gs, Gs^Efm, Gs, Ss, Gg, Gd^Fts, Gs, Gd, Re, Gd, Gd, Ds, Dd, Ds, Ds, Gd, Gs, Gg, Ww^Ewf, Ww, Rr^Vh, Rr, Re, Re, Rr, Rr, Rr^Vh, Gg^Gvs, Gg^Gvs, Re, Gg^Efm, Re, Re, Re
Dd, Ds, Gs^Ft, Ss^Em, Gll^Ft, Gll^Ft, Gg, Gg, Gg, Gg, Ss, Gg, Gg, Gll^Fts, Gll^Ft, Re, Re, Ds^Edpp, Ds, Dd, Ds, Gd, Gd^Fts, Gg^Efm, Gg, Wo, Ss^Em, Gg^Es, Gg, Gg, Gg^Es, Re, Re^Eff, Re^Eff, Re^Eff, Gs^Fp, Gs^Fp, Gg, Gg^Em, Gg
Ss, Ds, Ss, Ss, Gll^Ft, Ss, Ww^Bw|r, Ds, Ds, Ss, Rb, Ds, Dd, Gll^Ft, Ds^Edpp, Gll^Fts, Re, Gd, Gd, Gd, Gd, Gs, Gg, Gg, Gg^Efm, Ww^Wkf, Ss, Gg^Gvs, Gs^Fms, Gs^Fp, Re, Re, Gs^Fms, Re^Eff, Gg, Gs^Fp, Gg, Gs^Es, Gs^Fp, Hh
Wo, Ss, Ss, Ds^Ewsh, Dd, Ds, Ww^Bw|r, Ww^Ewl, Ss^Wkf, Ss, Ss, Ds, Ss, Ds, Dd^Edpp, Gll^Ft, Gs^Fts, Re^Es, Gs^Es, Gs^Efm, Gs, Ds, Gg, Gg, Gg, Ss^Em, Ss, Gg, Gs^Fp, Gs^Fms, Re, Gg, Gg^Efm, Gg^Qhh, Hh^Qhh, Gg^Qhh, Gs^Qhh, Hh, Gll^Fms, Hh
Ww, Ww^Ewl, Wo, Wo^Wkf, Ww, Ww, Gll, Ww^Wkf, Ss, Ss, Ss, Ss, Ds^Edpp, Ds, Gg^Efm, Gs^Ft, Re, Re, Gs, Gll^Fts, Gs^Ft, Gg, Gg, Gg^Efm, Gg, Ss, Ss, Gg, Gg^Efm, Gg, Re, Gg^Edpp, Gs^Edpp, Gs^Qhh, Gs^Fms, Gs^Fms, Hh^Qhh, Gs^Fms, Gs^Fms, Hh
Ss, Ww^Wkf, Ss, Wwrt, Ww, Ss, Re, Wo^Wkf, Ww, Dd, Ds^Ewsh, Ss, Ds, Ds, Gg, Re^Vh, Ds^Edpp, Ds, Gs^Edpp, Gll^Fts, Gll^Fts, Gg, Gs^Fp, Gll^Fp, Gs^Fp, Ss, Gg, Gg, Re^Eff, Re^Eff, Re^Eff, Re^Vh, Hh, Gs^Fp, Hh, Gs^Fms, Gs^Fds, Gs^Qhh, Gll^Qhh, Gs^Qhh
Ss, Ss, Gs^Fts, Dd, Ss, Ww, Ww^Bw|r, Ww, Ww, Wo, Ww^Ewf, Dd, Gs^Ft, Ss, Ss, Ss, Gll^Ft, Ds, Gg^Es, Gg, Gg^Efm, Gg, Gs^Fp, Gs^Fms, Gs, Ss, Ss^Em, Ss, Gg, Re^Eff, Gs^Fds, Hh^Efm, Hh^Fp, Hh^Dr, Gs, Hh^Fp, Gs^Qhh, Gll^Fms, Gs^Es, Gs
Ss, Gs^Ft, Ds^Es, Ds^Es, Ss^Em, Ss, Ss^Vhs, Ss, Ss, Wo, Wo^Wkf, Ds^Es, Gs^Ft, Ss, Gs^Ft, Gg, Gg, Gs^Fts, Gg^Efm, Gs^Fms, Gg, Gg, Gll^Fms, Gll^Fms, Gs^Fp, Ss, Gs^Fp, Ss, Gg, Gll^Fds, Hh, Hh, Gs^Fms, Hh^Es, Gs, Hh^Fp, Hh, Gs^Qhh, Hh, Hh^Es
Ds, Dd, Ds, Ss^Efm, Ss, Ss^Em, Chs, 2 Khs, Ss, Ww^Wkf, Ww^Wkf, Wwrt, Ww, Ss, Gs^Ft, Gs^Fts, Gg^Em, Gg, Gg^Qhu, Gg^Qhu, Gs^Fp, Gll^Fp, Gs^Fms, Gs^Fms, Gll^Fp, Ss, Ss, Ss, Ss, Gs^Fms, Hh^Fp, Gs^Fms, Gs^Fms, Gs, Hh^Es, Hh^Efm, Hh^Fp, Hh^Fp, Gs^Qhh, Gs^Fp
Gs^Ft, Gs^Fts, Dd, Ss, Ss^Efm, Ss, Ss, Chs, Ss^Em, Ds^Ewsh, Dd, Wo, Ww^Ewl, Gs^Ft, Gs^Ft, Gs^Ft, Gs^Fts, Gs^Fms, Gg^Qhu, Gg^Qhu, Gll^Fp, Gs^Fms, Gs^Fms, Gll^Fp, Ss, Rb, Gs^Fp, Ss, Hh, Hh, Gs^Fms, Hh, Gs, Hh^Fp, Hh^Fp, Gs, Gs^Fp, Gs^Fms, Gs^Qhh, Gs^Qhh
Ds, Gs^Ft, Gs^Ft, Ds, Ds, Ss, Ss, Ss, Ss, Ss, Ss, Wo, Ww, Ww, Ss, Ss, Gs^Ft, Gs^Ft, Gs^Qhu, Gs^Qhu, Gs^Fp, Gs^Fp, Ss, Ss, Ss, Ss, Gg, Gs, Hh, Gs^Fp, Gs^Fp, Gs^Fp, Hh^Fp, Hh^Fp, Gs, Gs, Gs^Fp, Gs^Fms, Gs^Fp, Gs^Fp
