Gd, Uu, Ur^Em, Isa, Isa, Xu, Xu, Xos, Xos, Xu, Xu, Xos, Xu, Xos, Xos, Xu, Xu, Xu, Xu, Xu, Xu, Xu, Xu, Xu, Xu, Xu, Xu, Xu, Xu, Qxu, Xu, Xu, Ur^Dr, Uh, Re, Uh, Uh, Xu, Xu, Xu
Wot^Qhu, Ur^Em, Wot^Qhu, Wot^Qhu, Wot^Qhu, Isa^Dr, Isa^Dr, Xos, Xos, Xos, Isa^Dr, Xu, Isa^Dr, Xos, Xu, Xos, Xos, Xu, Xu, Xu, Xu, Xu, Xu, Xu, Xu, Xu, Xoa, Xu, Xu, Xu, Xu, Ur^Dr, Ur^Dr, Re^Em, Uh^Em, Uh^Dr, Uh^Em, Xu, Xu, Xu
Gd^Em, Wot^Qhu, Re, Gd^Em, Wot^Qhu, Isa, Isa, Isa^Qhh, Isa^Qhh, Isa^Qhh, Xos, Isa, Isa^Eqf, Isa^Dr, Isa^Em, Isa^Dr, Xos, Xos, Xu, Xu, Xu, Xu, Xu, Xu, Xoa, Xoa, Xoa, Xu, Xoa, Xu, Ur^Dr, Uh^Em, Ur^Em, Re^Em, Uh^Dr, Xu, Xu, Xu, Xu, Xu
Uu, Re, Gd^Em, Wot^Qhu, Ur^Em, Xu, Xu, Isa^Efs, Isa^Efs, Isa^Qhh, Isa^Qhh, Xos, Xos, Isa^Eqf, Xos, Isa^Pr/o, Ur^Qhu, Ur^Qhu, Ur^Qhu, Xu, Xu, Xu, Xu, Uh^Dr, Isa^Dr, Isa^Dr, Qxu^Bs\, Xoa, Cf^Dr, Xoa, Ur, Ur^Dr, Xu, Uh, Xu, Xu, Xu, Xu, Xu, Xu
Xu, Uu^Vu, Re, Wot^Qhu, Ur^Em, Ur^Dr, Ur^Vu, Isa^Em, Wot^Qhu, Isa, Urb^Dr, Urb^Eff, Urb^Eff, Xos, Xu, Ur^Qhu, Xu, Ur^Qhu, Ur^Qhu, Xu, Uh, Xu, Isa, Uh, Isa^Qhh, Qxu, Qxu, Cf^Em, 2 Kf, Ur^Dr, Xoa, Xu, Xu, Xu, Xu, Xu, Xu, Xu, Xu, Xu
Xu, Xu, Uu^Em, Wot^Qhu, Wot^Qhu, Wot^Qhu, Wot^Qhu, Wot^Qhu, Urb^Br/, Wot^Qhu, Wot^Qhu, Urb^Br/, Isa^Dr, Isa^Dr, Xu, Xu, Xu, Ur^Qhu, Ur^Qhu, Isa^Dr, Ur^Dr, Isa^Vud, Isa^Em, Ur^Qhu, Isa^Qhh, Qxu, Qxu^Bs/, Cf^Em, Cf^Em, Cf^Em, Qxu^Bs\, Xoa, Ur^Dr, Xu, Xu, Xu, Xu, Xu, Xu, Xu
Xu, Xu, Xu, Xu, Uu^Qhu, Uu^Qhu, Urb^Br/, Urb^Dr, Urb^Br/, Urb^Dr, Wot^Qhu, Isa^Em, Isa, Isa, Xu, Xu, Xu, Uh^Efs, Xu, Isa, Uh, Ur^Em, Isa, Ur^Qhu, Ur^Qhu, Isa^Qhh, Qxu, Qxu, Qxu^Bs|, Qxu, Qxu, Isa^Qhh, Ur^Qhu, Xoa, Xu, Ur^Dr, Xu, Xu, Xu, Xu
Qxu, Qxu, Qxu, Qxu, Urb^Br/, Urb^Dr, Urb^Br/, Urb^Br/, Re^Qhu, Wot^Qhu, Qxua, Wot^Qhu, Isa^Em, Xu, Xu, Xu, Xu, Xu, Xu, Xu, Xu, Ur^Dr, Uh, Isa^Em, Ur^Qhu, Isa^Qhh, Isa^Dr, Qxu, Isa^Qhh, Qxu, Isa^Dr, Isa^Qhh, Ur^Qhu, Isa^Em, Uh, Ur^Dr, Uh, Xu, Xu, Xu
Xu, Xu, Qxu, Qxu^Br/, Qxu, Urb^Br/, Qxu, Qxu^Qhu, Re^Qhu, Wot^Qhu, Wot^Qhu, Wot^Qhu, Re^Qhh, Xu, Xu, Xu, Xos, Xu, Xu, Xu, Xu, Uh, Isa^Vud, Isa, Isa^Dr, Ur^Qhu, Ur^Qhu, Isa^Dr, Ur^Qhu, Isa^Qhh, Ur^Qhu, Ur^Qhu, Isa^Em, Xu, Xu, Xu, Uh^Em, Xu, Xu, Xu
Uu^Br/, Urb^Br/, Qxu, Re^Br/, Qxu, Qxu, Qxu, Re^Dr, Xu, Re^Qhu, Re^Qhu, Re^Qhu, Re^Qhu, Re^Qhu, Re^Qhu, Xos, Isa^Vud, Xos, Xos, Xu, Xu, Xu, Uh, Ur^Dr, Ur^Em, Isa, Isa, Ur^Qhu, Isa, Ur^Qhu, Isa, Isa, Xu, Xu, Xu, Xu, Xu, Ur^Dr, Xu, Xu
Urb^Br/, Urb^Dr, Qxu, Qxu, Qxu, Qxu, Re^Qhu, Qxu, Xu, Xu, Re^Qhu, Re^Qhu, Re^Dr, Xos, Isa^Vud, Isa, Isa^Em, Cud, Isa^Em, Xos, Xos, Xu, Xu, Ur^Dr, Uh, Ur^Dr, Uh, Isa^Vud, Uh, Ur^Em, Ur^Dr, Ur^Dr, Xu, Xu, Xu, Xu, Xu, Ur^Dr, Uh, Xu
Uu, Qxu, Qxu, Re, Re^Qhh, Qxu, Re^Qhh, Re^Dr, Qxu, Xu, Qxu, Qxu^Qhu, Xu, Xos, Xos, Cud, Isa^Dr, Isa^Em, Isa, Isa^Em, Cud, Xos, Xos, Xu, Xu, Xu, Xu, Xu, Xu, Xu, Xu, Ur^Dr, Re^Qhu, Xu, Re^Dr, Re^Qhu, Gd^Qhu, Xu, Uu^Dr, Xu
Xos, Uu, Xos, Qxu, Qxu, Qxu, Qxu, Qxu, Re, Qxu, Qxu, Re^Dr, Xos, Xu, Isa^Eb, Xos, Xos, Isa^Em, Cud, Isa^Em, Isa, Isa^Em, Isa, Xos, Xos, Xu, Xu, Xu, Xu, Xu, Uh^Dr, Uh^Efs, Re^Qhu, Qxu, Qxu, Qxu, Qxu, Re^Qhh, Qxu, Re^Dr
Isa^Dr, Xos, Xos, Xos, Uu^Qhh, Re, Qxu, Qxu, Xos, Xos, Xos, Xos, Isa^Dr, Isa^Qhu, Isa^Qhh, Isa^Qhh, Isa^Eb, Xos, Xos, Isa, Isa^Em, Isa, Isa, Cud, Isa^Em, Xos, Xos, Xu, Xu, Xu, Re^Qhh, Re^Dr, Gd, Qxu, Qxu, Qxu^Ii, Qxu, Qxu, Qxu, Qxu
Isa^Dr, Isa^Dr, Isa^Dr, Xos, Xos, Uu^Dr, Xos, Xos, Isa^Dr, Xu, Isa^Dr, Xos, Isa^Pr\, Isa^Em, Isa, Isa^Qhu, Xos, Xos, Isa, Isa^Pr\, Xos, Cud, Isa^Em, Isa, Isa, Isa^Em, Cud, Xos, Xos, Xu, Qxu, Re^Qhh, Qxu, Qxu^Ii, Qxu, Qxu, Qxu^Ii, Qxu, Qxu, Qxu
Xos, Isa^Em, Isa^Pr/, Isa^Pr/, Isa, Xos, Xos, Isa^Em, Isa, Isa^Dr, Isa^Em, Isa, Isa, Xos, Xos, Xos, Isa^Dr, Isa, Xos, Xos, Uu^Dr, Xos, Xos, Isa^Em, Cud, Isa^Em, Isa, Isa^Dr, Isa^Em, Xos, Qxu, Qxu, Qxu, Qxu^Ii, Qxu, Gd^Ii, Gd^Edpp, Re^Ii, Qxu, Qxu
Isa^Vud, Xos, Isa^Pr\o, Isa^Em, Isa^Pr/, Isa^Pr/o, Isa, Xos, Isa^Pr\o, Isa, Isa, Isa^Dr, Isa^Em, Uu^Vud, Isa^Em, Isa^Pr\, Xos, Xos, Uu^Qhh, Uu^Qhh, Xu, Uu^Dr, Uu, Xos, Xos, Isa, Isa^Em, Isa^Vud, Qxu, Qxu^Bs\, Qxu^Bs\, Qxu, Re^Qhh, Gd^Qhh, Qxu, Re^Ii, Qxu^Ii, Gd^Ii, Gd^Qhh, Urb
Isa^Em, Isa, Isa, Xos, Xos, Isa, Isa^Dr, Isa^Em, Xu, Xos, Xos, Isa^Dr, Xu, Isa^Dr, Isa^Em, Isa, Isa^Dr, Xos, Xos, Uu^Qhu, Re, Qxu, Re, Qxu, Qxu, Xos, Qxu, Qxu^Bs\, Qxu^Bs\, Qxu, Qxu, Qxu^Bs\, Re, Re^Vu, Qxu, Qxu, Gd^Ii, Gd^Edpp, Qxu, Qxu
Isa^Vud, Isa^Vud, Xos, Xos, Xos, Xos, Xu, Xu, Xu, Xu, Xu, Xos, Xos, Isa^Dr, Isa^Em, Isa^Em, Xos, Xos, Uu, Uu^Vu, Gd, Qxu, Qxu^Bs|, Qxu, Re^Qhu, Qxu, Qxu, Qxu, Qxu, Qxu^Bs\, Re^Qhu, Re^Qhu, Re, Re^Qhu, Qxu, Rb^Edpp, Re^Qhu, Gd^Qhu, Qxu, Qxu
Xu, Xu, Xur, Xos, Xur, Xur, Xu, Xu, Xu, Xuf, Xur, Xu, Xu, Xos, Xos, Xos, Uu^Dr, Uu^Qhu, Xu, Re, Qxu, Qxu, Uu, Re^Edp, Gd^Ii, Re^Edpp, Xu, Xu, Qxu, Gd, Qxu, Re^Qhh, Re^Qhh, Re, Qxu^Bs\, Qxu, Qxu, Qxu^Bs\, Re, Qxu
Xu, Xos, Xos, Xu, Xu, Xuf, Xu, Xur, Uue^Qhh, Uu^Qhu, Uhe^Vu, Xur, Xu, Xuf, Xu, Xu, Uu^Qhh, Xu, Xu, Qxu, Re, Qxu^Ii, Qxu, Qxu, Re, Re^Qhu, Qxu^Bs\, Xu, Qxu, Qxu, Re, Re^Qhu, Re^Dr, Qxu, Qxu, Qxu^Bs\, Re, Re^Qhu, Re^Qhu, Re^Qhh
Xos, Xos, Xur, Xur, Uue^Qhh, Uue^Qhh, Uue^Qhu, Uu^Dr, Wot^Wkf, Uue^Em, Uue^Qhu, Uu^Dr, Uu^Qhh, Uu^Em, Uu^Qhu, Xur, Re, Re, Qxu, Qxu, Re^Qhu, Gd^Vht, Re^Dr, Qxu^Bs/, Qxu, Qxu, Xu, Qxu^Bs\, Uu, Qxu^Bs/, Qxu, Qxu, Xu, Xu, Xu, Qxu, Qxu, Re^Qhu, Re^Dr, Re^Dr
Xu, Xuf, Uu, Uu^Qhh, Xuf, Xur, Xuf, Xur, Uue^Em, Uue^Qhh, Uue^Qhh, Uue, Xu, Xur, Uu^Qhu, Xu, Uu, Qxu, Re, Qxu, Qxu, Re^Edp, Re^Qhh, Xu, Qxu, Qxu^Ii, Xu, Qxu, Qxu^Bs|, Xu, Qxu, Qxu, Re^Dr, Xu, Qxu^Bs/, Re^Dr, Re^Qhu, Re^Qhu, Qxu, Qxu
Xu, Xur, Uhe, Xu, Uue^Em, Xu, Wot^Wkf, Xur, Xur, Uu^Qhu, Uue^Em, Wot^Wkf, Xu, Xu, Xur, Uu^Qhh, Xu, Uu^Dr, Xu, Qxu, Xu, Xu, Uu, Qxu^Bs\, Qxu^Bs\, Qxu, Qxu, Qxu, Uu, Qxu, Re^Qhh, Re^Qhh, Xu, Re^Vu, Qxu, Qxu, Qxu^Bs/, Re, Qxu, Qxu
Xu, Uue^Qhh, Xu, Uu^Qhu, Xur, Uue, Xu, Xuf, Xur, Xur, Uue^Qhu, Uhe^Qhh, Xu, Xuf, Uue^Qhh, Xur, Xu, Xuf^Dr, Xu, Qxu, Qxu, Re^Dr, Qxu, Qxu, Qxu, Qxu, Re^Qhu, Qxu^Bs/, Qxu, Qxu, Re^Qhu, Re^Qhu, Gd, Qxu^Ii, Qxu^Ii, Re, Re^Qhu, Qxu, Qxu, Qxu
Xuf, Uu, Xuf, Xuf, Uue^Em, Uu^Vu, Uh, Re^Em, Re^Em, Uue^Dr, Uue^Qhu, Uu^Vu, Xuf, Xu, Uue, Xur, Uu^Qhu, Wot^Wkf, Xu, Xu, Re, Uu^Edp, Xu, Qxu^Ii, Qxu, Qxu, Qxu, Re^Qhu, Re^Qhh, Qxu, Qxu, Qxu, Re, Gd^Qhh, Xu, Xu, Re, Re, Re, Qxu
Uu^Em, Xu, Xur, Xur, Uue^Qhh, Xu, Xur, Uu, Xur, Uu^Em, Xur, Xu, Uu^Qhu, Xur, Uu^Qhh, Uu, Xur, Uu^Em, Uu^Qhh, Uu, Uu^Qhh, Uu^Em, Gd, Qxu, Xos, Qxu, Qxu, Re^Qhu, Gd^Qhu, Re^Qhh, Re^Qhh, Qxu^Bs/, Qxu, Qxu, Xu, Xu, Xu, Re^Qhh, Xu, Xu
Uu^Em, Uue^Em, Uu^Qhu, Uue, Uu^Em, Uue^Em, Uhe, Uu, Xur, Uue, Uu^Qhh, Uu^Em, Uu, Uu^Em, Xur, Uu^Em, Xuf, Uu^Em, Xu, Uu^Vu, Uu^Em, Uu^Qhu, Xos, Xos, Isa^Dr, Xos, Xos, Re^Qhu, Re^Qhh, Re^Qhu, Qxu, Xu, Xu, Qxu, Re^Qhu, Xu, Re, Re^Qhh, Re, Xu
Xur, Ce, 1 Ket, Ce, Xu, Xur, Uue^Qhh, Xur, Xuf, Uu, Uue, Xur, Xu, Uu^Qhu, Xuf, Xu, Xos, Xu, Xuf, Uu^Qhh, Uu^Pw/o, Xos, Isa^Eqf, Isa^Dr, Isa^Eqp, Isa^Eqf, Isa^Efs, Re^Qhu, Re^Qhu, Re^Qhh, Re^Qhh, Xu, Qxu, Qxu, Re^Qhh, Re^Qhu, Re^Vu, Xu, Xu, Qxu
Xur, Xur, Ce, Uu^Em, Uue^Qhh, Uue^Em, Uue^Em, Wot^Wkf, Xur, Xuf, Xu, Xu, Xu, Xu, Xos, Xos, Xu, Xos, Xos, Xos, Isa^Em, Isa^Em, Isa^Eqf, Isa^Eqf, Isa^Dr, Isa^Em, Isa^Efs, Isa, Isa^Eqf, Xos, Xos, Re^Dr, Qxu^Bs\, Xu, Qxu, Qxu, Re^Qhh, Xu, Qxu, Xu
Xur, Xur, Xuf, Uu^Em, Uh, Uu^Qhu, Xur, Uu^Dr, Xur, Xuf, Xos, Xos, Xos, Xos, Isa^Dr, Xu, Isa^Dr, Isa^Dr, Isa^Vud, Xos, Xos, Isa^Eqf, Isa^Em, Isa^Em, Isa, Isa, Isa^Eqf, Isa^Efs, Isa^Em, Isa^Vud, Xos, Qxu, Qxu, Re, Re, Qxu^Bs/, Qxu, Re^Dr, Xu, Qxu
Xu, Xur, Xuf, Xur, Uu^Dr, Uu^Vu, Xur, Uu, Uh^Qhu, Uu^Em, Xu, Xos, Isa^Pr\o, Isa^Em, Isa^Em, Isa^Dr, Isa, Isa^Dr, Isa^Pr/o, Isa^Pr/, Isa^Dr, Isa^Dr, Isa, Isa^Dr, Isa^Eqf, Isa^Eqf, Isa^Eqf, Isa^Em, Xos, Isa^Pr/, Isa, Qxu, Qxu, Re^Qhu, Qxu^Bs\, Xu, Qxu, Xu, Xu, Xu
Xu, Xu, Uue^Qhh, Xur, Uu^Em, Xur, Wot^Wkf, Xu, Uue^Em, Uu^Qhu, Uu^Qhu, Uu^Qhu, Uu^Qhu, Xos, Xos, Isa, Xos, Xos, Xos, Isa, Isa^Dr, Xu, Xos, Xos, Xos, Isa^Eb, Xos, Xos, Xu, Xu, Uu^Qhu, Re^Qhu, Xu, Qxu, Xu, Qxu, Qxu^Bs\, Qxu, Xu, Qxu
Xu, Xu, Uu, Uh, Uu^Qhu, Uue^Em, Uu^Qhu, Xur, Uu^Qhu, Uu^Qhh, Xu, Uu^Qhu, Xuf, Xuf, Xos, Xos, Isa^Dr, Isa^Em, Isa, Isa^Pr\, Xos, Xos, Xos, Isa^Em, Isa^Pr/, Xos, Xos, Uu^Em, Uu^Qhu, Xu, Uu^Qhu, Xu, Xu, Xu, Xu, Qxu, Re^Qhh, Re^Dr, Xu, Xu
Xu, Xuf, Xu, Uue^Qhh, Xu, Xu, Xu, Uu^Qhu, Xu, Uu^Qhu, Xu, Xu, Xos, Xos, Isa, Isa^Pr\o, Xos, Xos, Xos, Isa, Isa, Isa, Urb, Xos, Xos, Isa^Em, Isa, Xos, Xos, Uu^Qhu, Uu^Qhu, Xu, Xu, Xu, Qxu, Qxu, Qxu, Re, Qxu, Qxu
